10
1111111111
1111111111
1111111111
1111111111
1111111111
1111111111
1111111111
1111111111
1111111111
1111111111
1111111111
1000000001
1100001101
1011001101
1000000001
1010001111
1010000001
1110100101
1000100101
1111111111
1111111111
1000000001
1010000001
1001011011
1110000001
1010000111
1010000001
1000100001
1000000001
1111111111
1111111111
1011000001
1000000111
1000000101
1000001101
1000000001
1100000101
1100000101
1001000001
1111111111
1111111111
1000100001
1000000001
1000001001
1000001001
1001000001
1001101001
1000000001
1011000001
1111111111
1111111111
1000000001
1000001001
1000011001
1010100001
1001000001
1000000101
1000000101
1000000111
1111111111
1111111111
1010000001
1010001001
1000000001
1010110001
1000100001
1010000101
1010000001
1000100111
1111111111
1111111111
1000000001
1000000001
1000000001
1000000001
1001e00001
1000000001
1000000001
1000000001
1111111111
1111111111
1010000001
1010000101
1111001001
1001010001
1000010101
1000000001
1010000101
1110000101
1111111111
1111111111
1000000001
10000s0001
1000000001
1000000001
1000000001
1000000001
1000000001
1000000001
1111111111