5
11111
11111
11111
11111
11111
1e001
11001
10111
11001
11001
10011
11111
11111
10001
10001
10101
10101
11001
10101
10001
10001
10101
100s1
11111
11111